NO ./textures/wall_1.xpm
SO ./textures/wall_2.xpm
WE ./textures/wall_3.xpm
EA ./textures/wall_4.xpm
D ./textures/door.xpm
SP ./textures/sprite.xpm[3]
F 50,50,50
C 180,180,220
        1111111111111111111111111
        1000000000110000000000001
        1011000001110000030000001
        1001000000200000000000001
111111111011000001110000000003001
100000000011000001112111111111111
11110111111111011100000010001
11112111111111211101010010301
11000000110101011103030010001
10030000000000001100000020001
10030000000000001101010010001
11000001110101011111011110E0111
11110111 1110101 101111010001
11111111 1111111 111111111111